NO ./tester_maps/textures/no.xpm
SO ./tester_maps/textures/so.xpm
WE ./tester_maps/textures/we.xpm
EA ./tester_maps/textures/ea.xpm
F 220,100,0
C 225,30,0

        1111111
        1000001
   11111000001
   1   000N0001
   1   011111111
   11111
