NO ./tester_maps/textures/no.xpm
SO ./tester_maps/textures/so.xpm
WE ./tester_maps/textures/we.xpm
EA ./tester_maps/textures/ea.xpm
F 220,100,0
C 225,30,0

11111
100S1
10001
11111
