NO ./tester_maps/textures/no.xpm
SO ./tester_maps/textures/so.xpm
WE ./tester_maps/textures/we.xpm
EA ./tester_maps/textures/ea.xpm

F 0,0,0
C 255,255,255

1111111111111111111111111111111111111111111111111111111111111111111
10000000000000000000000000000000000000000000000000000000000000000N1
1111111111111111111111111111111111111111111111111111111111111111111