NO ./code/textures/bookshelf_00.xpm
SO ./code/textures/bookshelf_01.xpm
WE ./code/textures/bookshelf_02.xpm
EA ./code/textures/bookshelf_03.xpm
F 50,100,0
C 225,30,0

    1111111111
1111100001
1N00000001
1111111111