NO ./code/textures/bookshelf_00.xpm
SO ./code/textures/bookshelf_01.xpm
WE ./code/textures/bookshelf_02.xpm
EA ./code/textures/bookshelf_03.xpm
F 50,100,0
C 225,30,0

 11111111111111111111111111111111111111111
1000000000000000000000000000000000000000001111
1000000000000000000000N00000000000000000001
1000000000000000000000000000000000000000001
10000000000000000000000000000000000000000011111
 11111111111111111111111111111111111111111