NO ./../textures/bookshelf_00.xpm
SO ./../textures/bookshelf_01.xpm
WE ./../textures/bookshelf_02.xpm
EA ./../textures/bookshelf_03.xpm

F 0,0,0
C 255,255,255

111111
100001
10E001
100001
111111
