-e 111111
1N0001
100001
111110
