-e 111111
100001
10N000
111111
